NO ./textures/rokitas.xpm
SO ./textures/cerca.xpm
WE ./textures/cerca.xpm
EA ./textures/rokitas.xpm

F 19, 95, 0
C 17, 96, 196


1111111111111111111111111111111111111111111111111111111111111111111111111111111111111111111111111111
10S0000000100000000000000000000000010000000000000000000000001000000000000000000000000100000000000001
1000000000000000000000000000000000000000000000000000100000000000000000000000010000000000000000000001
1000000000000000000001000000000000000000000000100000000000001000000000000000000000000100000000000001
1000000000100000000001000000000000010000000000100000000000001000000000000000000000000100000000000001
1111111111111111111111111111111111111111111111111111111111111111111111111111111111111111111111111111