NO ./textures/rokitas.xpm
SO ./textures/cerca.xpm
WE ./textures/cerca.xpm
EA ./textures/rokitas.xpm

F 19, 95, 0
C 17, 96, 196


            1111111111111111111111111111111111111111111111111111111111111111111111111111111111111111111111111111
        11110N0000000100100000000000000100000010000000000000000000000001000000000000000000000000100000000000001
    1111100000010001100000000000000111000000000000100000000010000000000000000000001001000000000000000000000111
11110000000110000000010000001000000000000111000100000000000001000000000000111000000000001000000000000011111
100000000010010100000100000010000000100000100010000000000000100000000000001000000000010000000000000111 11
100000000010010100000100000010000000100000100010000000000000100000000000001000000000010000000000000111 11
100000000010010100000100000010000000100000100010000000000000100000000000001000000000010000000000000111 11
100000000010010100000100000010000000100000100010000000000000100000000000001000000000010000000000000111 11
100000000010010100000100000010000000100000100010000000000000100000000000001000000000010000000000000111 11
100000000010010100000100000010000000100000100010000000000000100000000000001000000000010000000000000111 11
100000000010010100000100000010000000100000100010000000000000100000000000001000000000010000000000000111 11
100000000010010100000100000010000000100000100010000000000000100000000000001000000000010000000000000111 11
100000000010010100000100000010000000100000100010000000000000100000000000001000000000010000000000000111 11
100000000010010100000100000010000000100000100010000000000000100000000000001000000000010000000000000111 11
10000000000010100000100000010000000100000100010000000000000100000000000001000000000010000000000000111
111111111111111111111111111111111111111111111111111111111111111111111111111111111111111111111111111111 
100000000010010100000100000010000000100000100010000000000000100000000000001000000000010000000000000111 11
100000000010010100000100000010000000100000100010000000000000100000000000001000000000010000000000000111 11
100000000010010100000100000010000000100000100010000000000000100000000000001000000000010000000000000111 11
100000000010010100000100000010000000100000100010000000000000100000000000001000000000010000000000000111 11
10000000000010100000100000010000000100000100010000000000000100000000000001000000000010000000000000111
111111111111111111111111111111111111111111111111111111111111111111111111111111111111111111111111111111 
100000000010010100000100000010000000100000100010000000000000100000000000001000000000010000000000000111 11
100000000010010100000100000010000000100000100010000000000000100000000000001000000000010000000000000111 11
100000000010010100000100000010000000100000100010000000000000100000000000001000000000010000000000000111 11
100000000010010100000100000010000000100000100010000000000000100000000000001000000000010000000000000111 11
10000000000010100000100000010000000100000100010000000000000100000000000001000000000010000000000000111
111111111111111111111111111111111111111111111111111111111111111111111111111111111111111111111111111111 
100000000010010100000100000010000000100000100010000000000000100000000000001000000000010000000000000111 11
100000000010010100000100000010000000100000100010000000000000100000000000001000000000010000000000000111 11
100000000010010100000100000010000000100000100010000000000000100000000000001000000000010000000000000111 11
100000000010010100000100000010000000100000100010000000000000100000000000001000000000010000000000000111 11
10000000000010100000100000010000000100000100010000000000000100000000000001000000000010000000000000111
111111111111111111111111111111111111111111111111111111111111111111111111111111111111111111111111111111 
100000000010010100000100000010000000100000100010000000000000100000000000001000000000010000000000000111 11
100000000010010100000100000010000000100000100010000000000000100000000000001000000000010000000000000111 11
100000000010010100000100000010000000100000100010000000000000100000000000001000000000010000000000000111 11
100000000010010100000100000010000000100000100010000000000000100000000000001000000000010000000000000111 11
10000000000010100000100000010000000100000100010000000000000100000000000001000000000010000000000000111
111111111111111111111111111111111111111111111111111111111111111111111111111111111111111111111111111111   
  1     101
1111111111
1 101
1111