   WE                            ./textures/cerca.xpm
NO      ./textures/rokitas.xpm



SO ./textures/cerca.xpm

F 19 , 95 , 0

EA ./textures/rokitas.xpm



C 17 , 96 ,       196

111111111111111111111111
100000000000000000000001
100000000000000000000001
100000000N00000000000001
100000000000000000000001
100000000000000000000001
100000000000000000000001
100000111110000101010001
100000100010000000000001
100000100010000100010001
100000100010000000000001
100000111100001010100001
100000000000000000000001
100000000000000000000001
111111111000000000000001
100000000000000000000001
100000000000000000000001
111111111111111111111111
