NO ./textures/rokitas.xpm
SO ./textures/cerca.xpm
WE ./textures/cerca.xpm
EA ./textures/rokitas.xpm

F 19, 95, 0
C 17, 96, 196

        1111111111111111111111111
        1000000000110000000000001
        1011000001110000000000001
        1001000000000000000000001
111111111011000001110000000000001
100000000011000001110111111111111
11110111111111011100000010001
11110111111111011101010010001
11000000110101011100000010001
10000000000000000000000010001
10000000000000001101010010001
11000001110101011111011000S0111
11110111 1110101 101100010001
11111111 1111111 111111111111
