NO ./textures/rokitas.xpm
SO ./textures/cerca.xpm
WE ./textures/cerca.xpm
EA ./textures/rokitas.xpm

F 19, 95, 0
C 17, 96, 196

111111111111111111111
1W0000000000000000001
111111111111111111111
