NO ./textures/rokitas.xpm
SO ./textures/cerca.xpm
WE ./textures/cerca.xpm
EA ./textures/rokitas.xpm

F 19, 95, 0
C 17, 96, 196

111111111111111111111
1000000000000000000E1
111111111111111111111
