NO ./textures/rokitas.xpm
SO ./textures/cerca.xpm
WE ./textures/cerca.xpm
EA ./textures/rokitas.xpm

F 18,53,25
C 153,204,255


     111111111111    
111111      11   1
1         1 111       
111111111111    111111111111
10S000000001  
  
111111111111    1          1
                111111111111
      11         
111111111111




d
